00000000000000000000000000000000000000000000000000000000000000
00000000000000000000000000000000000000000000000000000000000000
00000000000000000000000000000000000000000000000000000000000000
00000000000000000000000000000000000000000000000000000000000000
00000000000000000000000000000000000000000000000000000000000000
000!)000000000000000000000000000000000000000000000000000000000
000$^000000000000000000000000000000000000000000000000000000000
000$^000000000000000000000000000000000000000000000000000000000
000$^0000000000000000000000000000000000000000000000000000000000
12222222222222222222222222222222222222222222222222230000000000
45555555555555555555555555555555555555555555555555560000000000
78888888888888888888888888888888888888888888888888890000000000