00000000000000000000000000000000000000000000000000000000000000
00000000000000000000000000000000000000000000000000000000000000
00000000000000000000000000000000000000000000000000000000000000
00000000000000000000000000000000000000000000000000000000000000
00000000000000000000000000000000000000000000000000000000000000
000!)000000000000000000000000000000000000000000000000000000000
000$^000000000000000000000000000000000000000000000000000000000
000$^000000000000000000000000000000000000000000000000000000000
000$^gggggtggggggg0b0000y00000cslma0cc000000000000000000000000
12222xxxxxxxxxxxxxxxx222x2222222222223000000000000000000000000
45555555555555555555555555555555555556000000000000000000000000
78888888888888888888888888888888888889000000000000000000000000