00000000000000000000000000000000000000000000000000000000000000
00000000000000000000000000000000000000000000000000000000000000
00000000000000000000000000000000000000000000000000000000000000
00000000000000000000000000000000000000000000000000000000000000
00000000000000000000000000000000000000000000000000000000000000
000!)000000000000000000000000000000000000000000000000000000000
000$^000000000000000000000000000000000000000000000000000000000
000$^000000000000000000000000000000000000000000000000000000000
000$^gggggtggggggg000000b0000000000000000000000000000000000000
12222xxxxxxxxxxxxx222222x2222222222222222222222222230000000000
45555555555555555555555555555555555555555555555555560000000000
78888888888888888888888888888888888888888888888888890000000000