00000000000000000000000000000000000000000000000012222300000000000000000
00000000000000000000000000000000000000000000000155555523000000000000000
00000000000000000000000000000000000000000000001555555555300000000000000
00000000000000000000000000000000000000000000004555555555530000000000000
00000000000000000000000000000000000000000000004555555555553000000000000
00000000000000000000000000000000000000000000015555555555555300000000000
00000000000000000130000000000000000000000000045555555555555600000000000
00000000000000001560000000000000000000000000045555555555555600000000000
00000000v00000015590000122222300000000000001255555555555555600000000000
000ptgggggggg0155900000785555900000000000015555555555555555600000000000
00122222222230459000230007556000000000000155588888888888888900000000000
00455555555590790000500000789000000000000455900000000000000000000000000
00455555555600000000500000000000000000001556000000000000000000000000000
00788888888900000007900000000000000000015556000000000000000000000000000
00000000000000000000000000000000000000015559000000000000000000000000000
00000000000001222222222230000000000000155590000000000000000000000000000
00000000000007555555555590000000000001555900000000000000000000000000000
00000000123000788888888900000000000015559000000000000000000000000000000
00000000456000000000000000000000000045590000000000000000000122222222223
00000000456000000000000000000000000078900000012222230000000455555555556
00000000456000012222222222222222230000000000045555560000000455555555556
00000000456000045555555555555555560000000000007888900000000455555555556
00000000455300045555555555555555560000000000000000000000000455555555556
00000000455523045555555555555555560000000000000000000000000788888888889
00000000788889045555555555555555560000000000000000000000000000000000000
00000000000000045555555555555555560000000000000000000000000000000000000
00000000000000045555555555555555560000000000000000000000000000000000000
00000000000000078888888888888888890000000000000000000000000000000000000