000000000000000000000000000000000000000000000000b0000t00000000000000000
00000000000000000000000000000000000000000000000012222x00000000000000000
00000000000000000000000000000000000000000000000155555523000000000000000
00000000000000000000000000000000000000000000001555555555300000000000000
000000000000000000000000000000000000000000000045555555m5530000000000000
00000000000000000000000000000000000000000000004555555555553000000000000
00000000000000000000000000000000000000000000015555555555555300000000000
00000000000000000130000000000000000000000000045555555l55555600000000000
00000000000000001560000000tgg00000000000000004555l555555555600000000000
00000000v00000015590000122xxx300000000000001255555555555555600000000000
000ptggggg0000155900000785s55900000000000015555555555555555600000000000
00122xxxxx2230459000230007556000000000000155588888888888888900000000000
0045555555c590790000500000789000000000000455900000000000000000000000000
00455555555600000000500000000000000000001556000000000000000000000000000
00788888888900000007900000000000000000015556000000000000000000000000000
0000000000000000000000ggb0000000000000015559000000000000000000000000000
0000000000000122222222xxx0000000000000155590000000000000000000000000000
00000000ggg00755s55s555590000000000001555900000000000000000000000000000
00000000xxx0007888888889000000000000155590000000000000000000gg00000gtgg
000000004560000000000000000000000000455900000000000000000001xx22222xxxx
000000004560000bggggg0000gggygg000007890000001222223000000045s555555556
0000000045600001xxxxx2222xxxxxx2230000000000045c55s6000000045s5555a5556
00000000456000045555555555555555560000000000007888900000000455555555556
000000004l530004555555s5555l5555560000000000000000000000000455555555556
00000000455523045555555555555555560000000000000000000000000788888888889
0000000078888904555cc55555555555560000000000000000000000000000000000000
0000000000000004555555c555555555560000000000000000000000000000000000000
00000000000000045555555555555555560000000000000000000000000000000000000
00000000000000078888888888888888890000000000000000000000000000000000000